{
	"size": [16,9,4],
	"path": [
		[0,4,0],
		[15,4,0]
	],
	"sprites": {
		"#": "wall",
		"_": "floor",
		"~": "lava"
	},
	"blocks": [
		"################",
		"#______________#",
		"#__~~~~~~~~~~__#",
		"#__~~~~~~~~~~__#",
		"________________",
		"#__~~~~~~~~~~__#",
		"#__~~~~~~~~~~__#",
		"#______________#",
		"################"
	]

}
